001000000000000000000!
001000000000000000000!
001000000000000000000!
001111100000000000000!
000000100000011111111!
000000100000010000000!
000000100000010000000!
000000100000010000000!
000000100000010000000!
000000111111110000000!
000000000000000000000!
000000000000000000000!