340000003000000100000
420030000003000100040
000000111111111100000
004000100000000002000
000000100300320004000
003000100000000430000
000000100024000002300
000000111111111110000
004200032000000010002
000023000042000010000
000000000000000011111
000002003000034000000