341000400032002000000
421002003000004000000
001000000030020004300
001111100003040000200
000000102000011111111
000400100003010000000
003000100400010000000
002300100020010003000
000000100000010002000
000000111111110000040
000000040000200030000
000000000000000000000