340000400000004001000!
420000201111111111000!
000034001000000000000!
002300001200004023000!
000024001000000000000!
000400001111110000000!
000300000000012004200!
000001111111110000200!
000421000240003000000!
000001320000000000030!
000001111111111111111!
000024000230000000300!