340000001000030002000
420000001111111100000
000022000034000100030
000003000230000100000
020000000000000100000
000200001111111100000
003000001000002000300
000240001003200340000
000040001000000030020
002000001111111111111